##################################################
#..O.O..#..O.O.O.O.......##O..OOO.....O...O..#..O#
#.O.O.#.....O..O......O.O.OOO.......OO.O.....#...#
#OO........O.....OO......##OO.#OO.OO..O....OOO...#
#......O...O..O.#....O...O.....O..#.O.O.O...#O...#
#OOO.OO.OO...####O.#O...O..OO...O#.O..#.OO.O...O.#
#O#...OOOO......O#O#....#OO...O.....O.O.OOO.OOO..#
#O.O...O.#OO......#...........O...OO.O..O#.#OO...#
#O.....O.O.O.#...OO..O#....OO.O.O....#.........O.#
#.O.#O.O#...O#..O.O.#.O.OO..O..O...O.O...OO.O...O#
#..#..O.#.O..##......OO...........O.....O...#.#..#
#.OO#.........O...O.....OO.O...OO............O#.O#
##.O.OO.O...O.O..O..OO.#....O.#....O......OOO...O#
#..OO..O.O..O..O..O...O..O.....#OO.....O...#OOO.O#
#.......O.#O.OO..#......O..OO.......O..O.O....OO##
#.....O.........O...#.O..O..#OO.O...O.O.#....O...#
#.OO##O#..O.#..O......OO..OO.OO.....O..OO#O.O..O##
#.O....O...#O.O..O#....O#O...OO.....O....O.......#
#...OOO....#O.OO...#.OO#O...O#O..#..#.O..O....#..#
##....O.OO.O#..........O#.OOO.#....#...O#....OO..#
#.#OOO..OO..O.......#.OO.O..#O.#.OO....OO.O.....O#
#.O......#..O.#.O..........#O..O.OO...#O...O#....#
#.#....O.O....O.......O..OOO..OO...OO.#OOO.O.O.#.#
#.O.#.O.O....OOO...O...O#......OO##.O..OO.....O..#
#.OO.......#O.OO#..#....@O...O....OOO.O..OO......#
#O..#..#OO...O#OO.......OO..##..O.#.O.O..O.O..OO.#
#.#.O.OO.........OO#.O..O.O...OOO.O......O#...OO.#
#.OO...#..OO.##......O#.O.OO....O..O#.......O.OO##
#OO..O.O.O....O#.O..O......#...OO#.O..O.O..O..OOO#
#...OO....OOO.....O..O..O....OO......OOO.........#
#O...#.....O...O..OO..O.OO....O.O..O....O....O.O.#
#.....OOOO..#..#.O.OO.......O....OO#.O...O..O..O.#
##.OO...O.#O......#O.O#O#..O#..O.....O....OO..O.##
#..O..OOO...OO.OO.#O#.OOO......O...OO...O.O......#
#.OO.O..O.O.O#..O.#.O.OOO...O..OO.O##.O.#...#...O#
#........#...O##.....OO....O.O....OO#.O.O.O.#OO.O#
#.O..O.O.#...O.......#...#..O...O.#.........#..O##
#...........O.....O..OO.......#..#...O...#..O.##O#
#.OOO..O..OO....#..OOOO......O...##..#.......O...#
##..#O..OOO.#O...O..OO...O....OO..#..#.OO.O.OO...#
##O....#...OO#.O.O...O...O.O..O.......O.....O..#.#
#........#.O##...O#..O..O.#O........O#..OO#.O.O###
#....#.O............O..O...OO....OOO...OO...#....#
#.#O.....#...OO.OO.........#.#.OOO.OO.O...O#.O.#.#
##....#..OO...O...O..#O..O.O..O.O..O..O.OO.......#
#...........OO.O.O...O......O...O.OOO.....O..O...#
##O.O..O.O...O.....O.O.O.O.OO.#O.O.O..#.....#....#
##.O.......#O.#...O#O#O..O..#O..O....OO.O.O......#
#O...O.O.........O......O.......O......#..O.....##
##################################################
